AcquisitionAbort	Acquisition Abort
AcquisitionFrameCount	Acquisition Frame Count
AcquisitionFrameRate	Acquisition Frame Rate
AcquisitionFrameRateEnable	Acquisition Frame Rate Enable
AcquisitionMode	Acquisition Mode
AcquisitionStart	Acquisition Start
AcquisitionStatus	Acquisition Status
AcquisitionStatusSelector	Acquisition Status Selector
AcquisitionStop	Acquisition Stop
AutoFeatureCycleTime	Auto Feature Cycle Time
AutoFeatureHeight	Auto Feature Height
AutoFeatureOffsetX	Auto Feature Offset X
AutoFeatureOffsetY	Auto Feature Offset Y
AutoFeatureRegionMode	Auto Feature Region Mode
AutoFeatureRegionReference	Auto Feature Region Reference
AutoFeatureRegionSelector	Auto Feature Region Selector
AutoFeatureWidth	Auto Feature Width
BOPFShift	BOPFShift
BalanceWhiteAuto	Balance White Auto
BalanceWhiteAutoStatus	Balance White Auto Status
BinningHorizontal	Binning Horizontal
BinningHorizontalMode	Binning Horizontal Mode
BinningSelector	Binning Selector
BinningVertical	Binning Vertical
BinningVerticalMode	Binning Vertical Mode
BlackLevel	Black Level
BlackLevelSelector	Black Level Selector
BrightnessAutoNominalValue	Brightness Auto Nominal Value
BrightnessAutoPriority	Brightness Auto Priority
ChunkEnable	Chunk Enable
ChunkModeActive	Chunk Mode Active
ChunkSelector	Chunk Selector
ColorTransformationAuto	Color Transformation Auto
ColorTransformationEnable	Color Transformation Enable
ColorTransformationFactoryListSelector	Color Transformation Factory List Selector
ColorTransformationOutputColorSpace	Color Transformation Output Color Space
ColorTransformationResetToFactoryList	Color Transformation Reset To Factory List
ColorTransformationValue	Color Transformation Value
ColorTransformationValueSelector	Color Transformation Value Selector
CounterDuration	Counter Duration
CounterEventActivation	Counter Event Activation
CounterEventSource	Counter Event Source
CounterReset	Counter Reset
CounterResetActivation	Counter Reset Activation
CounterResetSource	Counter Reset Source
CounterSelector	Counter Selector
CounterValue	Counter Value
CounterValueAtReset	Counter Value At Reset
CustomData	Custom Data
CustomDataSelector	Custom Data Selector
DefectPixelCorrection	Defect Pixel Correction
DefectPixelListEntryActive	Defect Pixel List Entry Active
DefectPixelListEntryPosX	Defect Pixel List Entry PosX
DefectPixelListEntryPosY	Defect Pixel List Entry PosY
DefectPixelListIndex	Defect Pixel List Index
DefectPixelListSelector	Defect Pixel List Selector
DeviceCharacterSet	Device Character Set
DeviceEventChannelCount	Device Event Channel Count
DeviceFamilyName	Device Family Name
DeviceFirmwareVersion	Device Firmware Version
DeviceGenCPVersionMajor	Device Gen CP Version Major
DeviceGenCPVersionMinor	Device Gen CP Version Minor
DeviceLinkSelector	Device Link Selector
DeviceLinkSpeed	Device Link Speed
DeviceLinkThroughputLimit	Device Link Throughput Limit
DeviceManufacturerInfo	Device Manufacturer Info
DeviceModelName	Device Model Name
DeviceRegistersEndianness	Device Registers Endianness
DeviceReset	Device Reset
DeviceResetToDeliveryState	Device Reset To Delivery State
DeviceSFNCVersionMajor	Device SFNC Version Major
DeviceSFNCVersionMinor	Device SFNC Version Minor
DeviceSFNCVersionSubMinor	Device SFNC Version Sub Minor
DeviceScanType	Device Scan Type
DeviceSensorType	Device Sensor Type
DeviceSerialNumber	Device Serial Number
DeviceStreamChannelCount	Device Stream Channel Count
DeviceStreamChannelEndianness	Device Stream Channel Endianness
DeviceStreamChannelSelector	Device Stream Channel Selector
DeviceStreamChannelType	Device Stream Channel Type
DeviceTLType	Device TL Type
DeviceTLVersionMajor	Device TL Version Major
DeviceTLVersionMinor	Device TL Version Minor
DeviceTLVersionSubMinor	Device TL Version Sub Minor
DeviceTemperature	Device Temperature
DeviceTemperatureExceeded	Device Temperature Exceeded
DeviceTemperatureSelector	Device Temperature Selector
DeviceTemperatureStatus	Device Temperature Status
DeviceTemperatureStatusTransition	Device Temperature Status Transition
DeviceTemperatureStatusTransitionSelector	Device Temperature Status Transition Selector
DeviceType	Device Type
DeviceUSB3VisionGUID	Device USB3 Vision GUID
DeviceUserID	Device User ID
DeviceVendorName	Device Vendor Name
DeviceVersion	Device Version
EventNotification	Event Notification
EventSelector	Event Selector
ExposureAuto	Exposure Auto
ExposureAutoMaxValue	Exposure Auto Max Value
ExposureAutoMinValue	Exposure Auto Min Value
ExposureMode	Exposure Mode
ExposureTime	Exposure Time
FixedPatternNoiseCorrection	Fixed Pattern Noise Correction
FrameCounter	Frame Counter
Gain	Gain
GainAuto	Gain Auto
GainAutoMaxValue	Gain Auto Max Value
GainAutoMinValue	Gain Auto Min Value
GainSelector	Gain Selector
Gamma	Gamma
HDREnable	HDR Enable
HDRExposureRatio	HDR Exposure Ratio
HDRExposureRatioPercent	HDR Exposure Ratio Percent
HDRIndex	HDR Index
HDRPotentialAbs	HDR Potential Abs
Height	Height
HeightMax	Height Max
ImageData	Image Data
ImageDataEnable	Image Data Enable
InterfaceSpeedMode	Interface Speed Mode
LUTContent	LUT Content
LUTEnable	LUT Enable
LUTIndex	LUT Index
LUTSelector	LUT Selector
LUTValue	LUT Value
LineDebouncerHighTimeAbs	Line Debouncer High Time Abs
LineDebouncerLowTimeAbs	Line Debouncer Low Time Abs
LineInverter	Line Inverter
LineMode	Line Mode
LineSelector	Line Selector
LineSource	Line Source
LineStatus	Line Status
LineStatusAll	Line Status All
LostEventCounter	Lost Event Counter
MemoryMaxBlocks	Memory Max Blocks
OffsetX	Offset X
OffsetY	Offset Y
PayloadSize	Payload Size
PixelFormat	Pixel Format
ReadOutTime	Read Out Time
ReadoutMode	Readout Mode
ReverseX	Reverse X
ReverseY	Reverse Y
SIControl	SI Control
SIPayloadFinalTransfer1Size	SI Payload Final Transfer1 Size
SIPayloadFinalTransfer2Size	SI Payload Final Transfer2 Size
SIPayloadTransferCount	SI Payload Transfer Count
SIPayloadTransferSize	SI Payload Transfer Size
SensorEffectCorrection	Sensor Effect Correction
SensorHeight	Sensor Height
SensorName	Sensor Name
SensorPixelHeight	Sensor Pixel Height
SensorPixelWidth	Sensor Pixel Width
SensorShutterMode	Sensor Shutter Mode
SensorWidth	Sensor Width
SequencerConfigurationMode	Sequencer Configuration Mode
SequencerFeatureEnable	Sequencer Feature Enable
SequencerFeatureSelector	Sequencer Feature Selector
SequencerMode	Sequencer Mode
SequencerPathSelector	Sequencer Path Selector
SequencerSetActive	Sequencer Set Active
SequencerSetLoad	Sequencer Set Load
SequencerSetNext	Sequencer Set Next
SequencerSetSave	Sequencer Set Save
SequencerSetSelector	Sequencer Set Selector
SequencerSetStart	Sequencer Set Start
SequencerTriggerActivation	Sequencer Trigger Activation
SequencerTriggerSource	Sequencer Trigger Source
ShortExposureTimeEnable	Short Exposure Time Enable
TLParamsLocked	TL Params Locked
TestPattern	Test Pattern
TestPatternGeneratorSelector	Test Pattern Generator Selector
TestPendingAck	Test Pending Ack
TimerDelay	Timer Delay
TimerDuration	Timer Duration
TimerSelector	Timer Selector
TimerTriggerActivation	Timer Trigger Activation
TimerTriggerSource	Timer Trigger Source
TimestampLatch	Timestamp Latch
TimestampLatchValue	Timestamp Latch Value
TriggerActivation	Trigger Activation
TriggerDelay	Trigger Delay
TriggerEventTest	Trigger Event Test
TriggerMode	Trigger Mode
TriggerOverlap	Trigger Overlap
TriggerSelector	Trigger Selector
TriggerSoftware	Trigger Software
TriggerSource	Trigger Source
USB2SupportEnable	USB 2 Support Enable
UserOutputSelector	User Output Selector
UserOutputValue	User Output Value
UserOutputValueAll	User Output Value All
UserSetData	User Set Data
UserSetDataEnable	User Set Data Enable
UserSetDefault	User Set Default
UserSetFeatureEnable	User Set Feature Enable
UserSetFeatureSelector	User Set Feature Selector
UserSetLoad	User Set Load
UserSetSave	User Set Save
UserSetSelector	User Set Selector
UserSetStartAddressSelector	User Set Start Address Selector
Width	Width
WidthMax	Width Max